,CA_Confirmed,CA_Deaths,CA_Recovered,CA_Active,Date
0,242,4,0,238,2020-04-13 00:00:00+00:00
1,7049,274,0,6775,2020-04-13 00:00:00+00:00
2,8,0,0,8,2020-04-13 00:00:00+00:00
3,298,4,0,294,2020-04-13 00:00:00+00:00
4,242,3,0,239,2020-04-13 00:00:00+00:00
5,25,0,0,25,2020-04-13 00:00:00+00:00
6,114,0,0,114,2020-04-13 00:00:00+00:00
7,12846,328,0,12518,2020-04-13 00:00:00+00:00
8,1648,44,0,1604,2020-04-13 00:00:00+00:00
9,1445,58,0,1387,2020-04-13 00:00:00+00:00
10,445,2,0,443,2020-04-13 00:00:00+00:00
11,5,0,0,5,2020-04-13 00:00:00+00:00
12,474,3,0,471,2020-04-14 00:00:00+00:00
13,300,4,0,296,2020-04-14 00:00:00+00:00
14,13557,360,0,13197,2020-04-14 00:00:00+00:00
15,244,3,0,241,2020-04-14 00:00:00+00:00
16,7470,291,0,7179,2020-04-14 00:00:00+00:00
17,1490,69,0,1421,2020-04-14 00:00:00+00:00
18,8,0,0,8,2020-04-14 00:00:00+00:00
19,25,0,0,25,2020-04-14 00:00:00+00:00
20,1732,46,0,1686,2020-04-14 00:00:00+00:00
21,116,0,0,116,2020-04-14 00:00:00+00:00
22,246,4,0,242,2020-04-14 00:00:00+00:00
23,5,0,0,5,2020-04-14 00:00:00+00:00
24,301,4,0,297,2020-04-15 00:00:00+00:00
25,517,3,0,514,2020-04-15 00:00:00+00:00
26,25,0,0,25,2020-04-15 00:00:00+00:00
27,1870,48,0,1822,2020-04-15 00:00:00+00:00
28,5,0,0,5,2020-04-15 00:00:00+00:00
29,8,0,0,8,2020-04-15 00:00:00+00:00
30,246,4,0,242,2020-04-15 00:00:00+00:00
31,7953,334,0,7619,2020-04-15 00:00:00+00:00
32,1517,72,0,1445,2020-04-15 00:00:00+00:00
33,116,0,0,116,2020-04-15 00:00:00+00:00
34,14248,435,0,13813,2020-04-15 00:00:00+00:00
35,244,3,0,241,2020-04-15 00:00:00+00:00
36,26,0,0,26,2020-04-16 00:00:00+00:00
37,8447,385,0,8062,2020-04-16 00:00:00+00:00
38,1561,75,0,1486,2020-04-16 00:00:00+00:00
39,247,3,0,244,2020-04-16 00:00:00+00:00
40,1870,48,0,1822,2020-04-16 00:00:00+00:00
41,304,4,0,300,2020-04-16 00:00:00+00:00
42,549,3,0,546,2020-04-16 00:00:00+00:00
43,5,0,0,5,2020-04-16 00:00:00+00:00
44,246,5,0,241,2020-04-16 00:00:00+00:00
45,14860,487,0,14373,2020-04-16 00:00:00+00:00
46,8,0,0,8,2020-04-16 00:00:00+00:00
47,117,0,0,117,2020-04-16 00:00:00+00:00
48,117,0,0,117,2020-04-17 00:00:00+00:00
49,9840,490,0,9350,2020-04-17 00:00:00+00:00
50,250,5,0,245,2020-04-17 00:00:00+00:00
51,579,3,0,576,2020-04-17 00:00:00+00:00
52,1996,48,0,1948,2020-04-17 00:00:00+00:00
53,15857,630,0,15227,2020-04-17 00:00:00+00:00
54,26,0,0,26,2020-04-17 00:00:00+00:00
55,252,3,0,249,2020-04-17 00:00:00+00:00
56,5,0,0,5,2020-04-17 00:00:00+00:00
57,1561,75,0,1486,2020-04-17 00:00:00+00:00
58,8,0,0,8,2020-04-17 00:00:00+00:00
59,305,4,0,301,2020-04-17 00:00:00+00:00
60,307,4,0,303,2020-04-18 00:00:00+00:00
61,26,0,0,26,2020-04-18 00:00:00+00:00
62,8,0,0,8,2020-04-18 00:00:00+00:00
63,117,0,0,117,2020-04-18 00:00:00+00:00
64,10456,524,0,9932,2020-04-18 00:00:00+00:00
65,2397,50,0,2347,2020-04-18 00:00:00+00:00
66,1618,78,0,1540,2020-04-18 00:00:00+00:00
67,250,5,0,245,2020-04-18 00:00:00+00:00
68,606,4,0,602,2020-04-18 00:00:00+00:00
69,256,3,0,253,2020-04-18 00:00:00+00:00
70,5,0,0,5,2020-04-18 00:00:00+00:00
71,16798,688,0,16110,2020-04-18 00:00:00+00:00
72,253,5,0,248,2020-04-19 00:00:00+00:00
73,117,0,0,117,2020-04-19 00:00:00+00:00
74,257,3,0,254,2020-04-19 00:00:00+00:00
75,649,7,0,642,2020-04-19 00:00:00+00:00
76,5,0,0,5,2020-04-19 00:00:00+00:00
77,9,0,0,9,2020-04-19 00:00:00+00:00
78,17521,688,0,16833,2020-04-19 00:00:00+00:00
79,2562,51,0,2511,2020-04-19 00:00:00+00:00
80,11013,564,0,10449,2020-04-19 00:00:00+00:00
81,26,0,0,26,2020-04-19 00:00:00+00:00
82,1618,78,0,1540,2020-04-19 00:00:00+00:00
83,313,4,0,309,2020-04-19 00:00:00+00:00
84,26,0,0,26,2020-04-20 00:00:00+00:00
85,9,0,0,9,2020-04-20 00:00:00+00:00
86,254,5,0,249,2020-04-20 00:00:00+00:00
87,1647,81,0,1566,2020-04-20 00:00:00+00:00
88,315,4,0,311,2020-04-20 00:00:00+00:00
89,118,0,0,118,2020-04-20 00:00:00+00:00
90,11561,591,0,10970,2020-04-20 00:00:00+00:00
91,2803,51,0,2752,2020-04-20 00:00:00+00:00
92,675,9,0,666,2020-04-20 00:00:00+00:00
93,257,3,0,254,2020-04-20 00:00:00+00:00
94,17950,820,0,17130,2020-04-20 00:00:00+00:00
95,5,0,0,5,2020-04-20 00:00:00+00:00
96,118,0,0,118,2020-04-21 00:00:00+00:00
97,316,4,0,312,2020-04-21 00:00:00+00:00
98,257,3,0,254,2020-04-21 00:00:00+00:00
99,2908,59,0,2849,2020-04-21 00:00:00+00:00
100,12063,624,0,11439,2020-04-21 00:00:00+00:00
101,1699,86,0,1613,2020-04-21 00:00:00+00:00
102,26,0,0,26,2020-04-21 00:00:00+00:00
103,5,0,0,5,2020-04-21 00:00:00+00:00
104,11,0,0,11,2020-04-21 00:00:00+00:00
105,19319,939,0,18380,2020-04-21 00:00:00+00:00
106,721,9,0,712,2020-04-21 00:00:00+00:00
107,254,6,0,248,2020-04-21 00:00:00+00:00
108,3095,61,0,3034,2020-04-22 00:00:00+00:00
109,11,0,0,11,2020-04-22 00:00:00+00:00
110,1724,87,0,1637,2020-04-22 00:00:00+00:00
111,12715,694,0,12021,2020-04-22 00:00:00+00:00
112,257,3,0,254,2020-04-22 00:00:00+00:00
113,255,6,0,249,2020-04-22 00:00:00+00:00
114,26,0,0,26,2020-04-22 00:00:00+00:00
115,20126,1044,0,19082,2020-04-22 00:00:00+00:00
116,320,4,0,316,2020-04-22 00:00:00+00:00
117,737,10,0,727,2020-04-22 00:00:00+00:00
118,5,0,0,5,2020-04-22 00:00:00+00:00
119,118,0,0,118,2020-04-22 00:00:00+00:00
120,26,0,0,26,2020-04-23 00:00:00+00:00
121,257,6,0,251,2020-04-23 00:00:00+00:00
122,772,12,0,760,2020-04-23 00:00:00+00:00
123,20965,1134,0,19831,2020-04-23 00:00:00+00:00
124,118,0,0,118,2020-04-23 00:00:00+00:00
125,326,4,0,322,2020-04-23 00:00:00+00:00
126,3401,66,0,3335,2020-04-23 00:00:00+00:00
127,256,3,0,253,2020-04-23 00:00:00+00:00
128,11,0,0,11,2020-04-23 00:00:00+00:00
129,1795,93,0,1702,2020-04-23 00:00:00+00:00
130,5,0,0,5,2020-04-23 00:00:00+00:00
131,13718,762,0,12956,2020-04-23 00:00:00+00:00
132,331,4,0,327,2020-04-24 00:00:00+00:00
133,5,0,0,5,2020-04-24 00:00:00+00:00
134,262,6,0,256,2020-04-24 00:00:00+00:00
135,3720,68,0,3652,2020-04-24 00:00:00+00:00
136,118,0,0,118,2020-04-24 00:00:00+00:00
137,11,0,0,11,2020-04-24 00:00:00+00:00
138,1824,94,0,1730,2020-04-24 00:00:00+00:00
139,21838,1243,0,20595,2020-04-24 00:00:00+00:00
140,14068,806,0,13262,2020-04-24 00:00:00+00:00
141,827,16,0,811,2020-04-24 00:00:00+00:00
142,256,3,0,253,2020-04-24 00:00:00+00:00
143,26,0,0,26,2020-04-24 00:00:00+00:00
144,1853,98,0,1755,2020-04-25 00:00:00+00:00
145,256,3,0,253,2020-04-25 00:00:00+00:00
146,118,0,0,118,2020-04-25 00:00:00+00:00
147,14550,862,0,13688,2020-04-25 00:00:00+00:00
148,341,4,0,337,2020-04-25 00:00:00+00:00
149,26,0,0,26,2020-04-25 00:00:00+00:00
150,263,6,0,257,2020-04-25 00:00:00+00:00
151,4017,72,0,3945,2020-04-25 00:00:00+00:00
152,22616,1340,0,21276,2020-04-25 00:00:00+00:00
153,5,0,0,5,2020-04-25 00:00:00+00:00
154,11,0,0,11,2020-04-25 00:00:00+00:00
155,257,3,0,254,2020-04-26 00:00:00+00:00
156,23267,1446,0,21821,2020-04-26 00:00:00+00:00
157,26,0,0,26,2020-04-26 00:00:00+00:00
158,118,0,0,118,2020-04-26 00:00:00+00:00
159,11,0,0,11,2020-04-26 00:00:00+00:00
160,15009,914,0,14095,2020-04-26 00:00:00+00:00
161,1948,100,0,1848,2020-04-26 00:00:00+00:00
162,349,4,0,345,2020-04-26 00:00:00+00:00
163,267,6,0,261,2020-04-26 00:00:00+00:00
164,4233,73,0,4160,2020-04-26 00:00:00+00:00
165,5,0,0,5,2020-04-26 00:00:00+00:00
166,26,0,0,26,2020-04-27 00:00:00+00:00
167,15564,960,0,14604,2020-04-27 00:00:00+00:00
168,5,0,0,5,2020-04-27 00:00:00+00:00
169,118,0,0,118,2020-04-27 00:00:00+00:00
170,24109,1516,0,22593,2020-04-27 00:00:00+00:00
171,4480,73,0,4407,2020-04-27 00:00:00+00:00
172,353,4,0,349,2020-04-27 00:00:00+00:00
173,1948,100,0,1848,2020-04-27 00:00:00+00:00
174,258,3,0,255,2020-04-27 00:00:00+00:00
175,900,24,0,876,2020-04-27 00:00:00+00:00
176,11,0,0,11,2020-04-27 00:00:00+00:00
177,271,6,0,265,2020-04-27 00:00:00+00:00
178,11,0,0,11,2020-04-28 00:00:00+00:00
179,273,6,0,267,2020-04-28 00:00:00+00:00
180,258,3,0,255,2020-04-28 00:00:00+00:00
181,26,0,0,26,2020-04-28 00:00:00+00:00
182,365,5,0,360,2020-04-28 00:00:00+00:00
183,1998,104,0,1894,2020-04-28 00:00:00+00:00
184,118,0,0,118,2020-04-28 00:00:00+00:00
185,5,0,0,5,2020-04-28 00:00:00+00:00
186,4696,75,0,4621,2020-04-28 00:00:00+00:00
187,24983,1600,0,23383,2020-04-28 00:00:00+00:00
188,900,24,0,876,2020-04-28 00:00:00+00:00
189,15960,1022,0,14938,2020-04-28 00:00:00+00:00
190,11,0,0,11,2020-05-04 00:00:00+00:00
191,31873,2206,0,29667,2020-05-04 00:00:00+00:00
192,5766,95,0,5671,2020-05-04 00:00:00+00:00
193,282,6,0,276,2020-05-04 00:00:00+00:00
194,971,37,0,934,2020-05-04 00:00:00+00:00
195,18574,1326,0,17248,2020-05-04 00:00:00+00:00
196,5,0,0,5,2020-05-04 00:00:00+00:00
197,27,0,0,27,2020-05-04 00:00:00+00:00
198,433,7,0,426,2020-05-04 00:00:00+00:00
199,2171,114,0,2057,2020-05-04 00:00:00+00:00
200,118,0,0,118,2020-05-04 00:00:00+00:00
201,259,3,0,256,2020-05-04 00:00:00+00:00
202,19094,1446,0,17648,2020-05-05 00:00:00+00:00
203,5836,104,0,5732,2020-05-05 00:00:00+00:00
204,32631,2281,0,30350,2020-05-05 00:00:00+00:00
205,259,3,0,256,2020-05-05 00:00:00+00:00
206,2224,120,0,2104,2020-05-05 00:00:00+00:00
207,5,0,0,5,2020-05-05 00:00:00+00:00
208,283,6,0,277,2020-05-05 00:00:00+00:00
209,467,7,0,460,2020-05-05 00:00:00+00:00
210,27,0,0,27,2020-05-05 00:00:00+00:00
211,985,38,0,947,2020-05-05 00:00:00+00:00
212,118,0,0,118,2020-05-05 00:00:00+00:00
213,11,0,0,11,2020-05-05 00:00:00+00:00
214,991,41,0,950,2020-05-06 00:00:00+00:00
215,11,0,0,11,2020-05-06 00:00:00+00:00
216,5893,106,0,5787,2020-05-06 00:00:00+00:00
217,19468,1505,0,17963,2020-05-06 00:00:00+00:00
218,119,0,0,119,2020-05-06 00:00:00+00:00
219,33425,2399,0,31026,2020-05-06 00:00:00+00:00
220,259,3,0,256,2020-05-06 00:00:00+00:00
221,487,7,0,480,2020-05-06 00:00:00+00:00
222,5,0,0,5,2020-05-06 00:00:00+00:00
223,2232,121,0,2111,2020-05-06 00:00:00+00:00
224,27,0,0,27,2020-05-06 00:00:00+00:00
225,284,7,0,277,2020-05-06 00:00:00+00:00
